A

abacaxi - naná	
abaixar - mogûeîyb
abaixar-se - îeaŷbyk
abaixo (de) - gûyri, gûyrype
abalar - mongué
abanar (o fogo) - peîu
abandonar - eîar (s)
abano (para o fogo) - tatapekûaba 
abarrotar - esemõ (s)
abater - monguî
abatido - abangab
abdômen - tygé
abelha - eíra; eiruba; eirasy; (variedades): eirapûá, eirusu, îate'i, aîbu, amanasãîa, eîru, kapûerusu, etc.
abençoar - mongaraíb
abertura - îaîa; puka (mb)
abóbora - îurumũ
aborrecer - mopytubar
aborto - akyrara
abraçar - aîuban
abrasar - apy (s)
abrigar - mo'ang
abrigo - (no mato): taîupara, 'anga; (para barcos ou navios, abrigada): 'anga
abrir - 'ab; pirar
absolutamente (= de modo algum) - angá
absolutamente! (= não! de modo algum!) - erimã!
abundância - tesemõ; tynysema; tyba
acabado (= findo, concluído) - aûîé 
acabar - (intr.): pab; (tr.): moaûîé; mondyk; mombab
acalmar - monhyrõ; nongatu
acalmar-se - putusok ● rel. a vento: pyk
acariciar - momorang
acaso? -p'ipó? serã?
aceitar - mboryb; pysyrõ4
acenar - îepoeîtyk
acender - (o fogo): mondyk; (a luz): moendy
achar - gûasem; basem
achatado - peb
achatar - mombeb
acidez - taîa
ácido - aî (r, s)
acima (de) - sosé
açoitar - nupã
acolher - pysyrõ4
acomodar-se - by'ar
aconselhar - ekomonhang (s)
acontecer - por (xe)
acordado - pak ● jazer acordado: îubé
acordar - (intr.): pak; (tr.): mombak
acostumar-se - ikó /ekó (t)
acreditar (em) - erobîar
acudir - openhan2 (s)
acusar - mombe'u
adiantar-se - kuabĩ 
admiração - putupaba (mb)
admirado - putupab
admirar-se - putupab (xe)
adoecer - mara'ar (xe)
adorar - moeté
adormecer - (intr.): ker; (tr.): monger
adornar - moîegûak; moporang
adornar-se - îegûak
adultério - agûasá
adulto - teburusu
adversário - tupîara
afamado - i moerapûanymbyra (v. moerapûan)
afamar (= tornar famoso) - moerapûan
afastado - i pe'apyra (v. pe'a)
afastar - eîyî (s); pe'a; pe'arung; moîepe'a
afastar-se - syryk; tyryk; îeîyî
afável - îerekûab
afazeres - tekó
afiado - aembé (r, s)
afiar - aembe'e (s)
afinal - ko'yté
aflição - tekotebẽ; marana; moreaûsuba
afligir-se - ikotebẽ / ekotebẽ (t)
aflito - 'angekoaíb; maran; moreaûsub
afrouxar - mongué 
afugentar - monhegûasem
afundar - (tr.): pumĩ; (intr.): nhepumĩ
agarrar - pysyk
agasalhar (= hospedar) - mombytá
ágil - ara'a
agir - ikó / ekó (t)
agitado - ara'a
agitar - mongué
agitar-se - îemosusun; îepubur; îereb; nhemongué; amaran (xe)
agora - ko'yr ● agora mesmo: ko'yré
agouro - morangygûana ● fazer agouros: anong (s)
agradar - moapysyk
agradável - aysó; matueté; porambyrambyk
agradecer - kugûab
agredir - epenhan (s) 
agressão - porepenhana (m)
água - ty2; 'y 
aguado - 'a'y
aguar - ypyî (s)
aguardar - arõ (s)
aguçar - aembe'e (s); apûapin (s); moapûá2; moapûaobyr; mobyr2
agudo - apûá (r, s)
aguentar - porará
ah! - mã!
ah! oh! (como que entendendo algo ou lembrando-se disso) - to!
aí - a'epe; ebapó
ai! (de dor, desgosto ou irritação - de h.) - akaî; akaîgûá; teté; (de m.): akaîgûé; akaîguy
ainda - abé; bé ● ainda bem que: îá; iîá muru; (na neg.): ranhẽ
aipim - aîpĩ
ajudante - pytybõana (m) (v. pytybõ)
ajudar - pytybõ
ajuntamento - tyba
ajuntar - irumõ; moîerobyk; moîese'ar; mono'ong
ajuntar-se - no'ong; nhemondysyk; nheŷnhang2
alaranjado - pytang
alargar - moatã2 ● alargar as bordas de: oba'ok (s)
alargar-se - îoba'u
alcançar - upytyk (s)
alçar - upir (s)
alcoviteiro - manhana
aldeia - taba
alegrar - moesãî; mooryb
alegrar-se - îemooryb
alegre - esãî (r, s); oryb (r, s)
alegria - toryba; tesãîa
aleijado (adj.) - asyk
além - amõngoty, amõ 
algo - mba'e; mba'e amõ
algodão - amynyîu; amyniîu
alguém - abá; amõ abá 
algum (s, a, as) - amõ 
alho - 'ybarema
alhures (= mais para lá, para longe, em outra parte) - amõngoty
ali - (não vis.): akûeîpe, a'epe; (vis.): ãme; ûĩme
aliado - îekotŷara
alimentar - poî (-îo-)
alimento - tembi'u; i 'upyra
alisar - mosym
alma - 'anga ● alma fora do corpo: 'angûera
almoçar - karu
almofada - akangupaba
almofariz - unguá
altibaixos - asura
alto - (fal. de pessoas): puku; (rel. a coisas ou lugares): ybaté ● para o alto, para as alturas; às alturas, ao alto: ybaté
aluno (i.e., o que é ensinado por alguém) - temimbo'e
amado - saûsupyra [v. aûsub (s)]
amadurecer (intr.) - aîub (xe)
amaldiçoar - momburu
amamentar - mokambu
amanhã - oîrã; oîrandé
amanhecer - ko'em (xe)
amansar - mombub; momby'ar; nongatu
amante - agûasá
amar - aûsub (s); amotar
amarelar - moîub
amarelo (s.) - îuba
amarelo (adj.) - îub
amargo - rob
amargor - roba
amarrar - apytĩ ● amarrar pelas mãos: popûar
amassar - sok
ambos - mokõîbé
ameaça - angagûaba (v. anga'o)
ameaçar - momburu; anga'o; momboî
amedrontar - mosykyîé
amendoim - mandubi
amigo - temiaûsuba; taûsupara
amizade - poraûsuba (m); îoaûsuba
amolecer - membek; mombub
amontoado - atyra; tapûá
amontoar - moatyr
amor - taûsuba; îoaûsuba ● amor erótico: poropotara (m)
andar - gûatá ● andar com; fazer andar consigo: erogûatá
andorinha - taperá; myîu'i
anguloso - pem 
angústia - tekotebẽ 
angustiar-se - ekotebẽ (r, s) (xe) 
animal - (quadrúpede): so'o; (doméstico): mimbaba; temimbaba
anjo - apŷabebé; karaibebé
ano - akaîu; ro'y 
anoitecer - pytun (xe)
anta - tapi'ira
antecessor - tenondeara
anteontem - kûesé kûesé
antepassado - tamỹîpagûama
antes (adv.) - ranhẽ; (antes de): e'ymebé; enondé (r, s); îanondé
antigamente - akûeîme; erimba'e; kûesenhe'ym; raka'e
antigo - umûan
antropofagia - poru
antropófago - poru
anunciar - eronhe'eng; mombe'u
ânus - teîkûara
anzol - pindá
aonde? - mamõpe?
apagado - gûeb
apagar - (intr.): gûeb; (tr.): mogûeb
apalpar - abyky
apanhar - ekyî (s); pysyk
aparar - etab (s); pin (-îo-) 
aparecer - obasem (r, s); îekugûab
apartar - pe'a
apartar-se - îepe'a
apavorar - mosykyîé
apaziguar - monhyrõ 
apedrejar - api 
apenas (= tão somente) - sãî
aperfeiçoar - moaûîekatu
apertar - pyk (-îo-)
apesar (de) - îepé
apodrecer - tuîuk 
apoiar - kok (-îo-)
apoiar-se - îekok
após - riré; roîré; ré ● logo após, logo depois de: bé
aposento - koty
apreciar - momorang
aprender - nhembo'e
aprendiz (adj.) - nhembo'e
apressadamente - anhẽ
apressado - anhẽ (r, s)
apressar - moanhẽ
apressar-se - apûan (xe)
aprisionar - pysyk
aproximar-se - syk; kakar; erobyk; erosyk
aquecer - moakub; pé (-îo-)
aquele (a, es, as) (vis.): kûeî; ûĩ; (não vis.): a'e; aîpó; akó; akûeî 
aqui - iké; ké ● por aqui, para cá: kybõ; os daqui, os habitantes daqui: kybõygûara; keygûara
aquietar - moarybé; nongatu
aquietar-se - arybé (xe); pyk
aquilo - (não vis.): a'e; aîpó; akó; akûeîa; (vis.): kûeîa
ar - 'ara
aranha - nhandu'ĩ 
arar - yby'ab
arco - ybyrapara
arco-íris - îy'yba
arder (=queimar) - kaî
ardido - taî
árduo - aíb
areia - ybyku'i
argola - apỹîa; apynha
arisco - tyryk
arma - popesûara (m) ● arma de fogo: pokaba (m); pororokaba (m)
armação - ytá; kanga
armadilha - koty ● armadilha que tomba com peso ou estalando: mundé
arpoar - kutuk
arquear (para cima) - kandab
arraia - îabebyra
arrancar - 'ok (-îo-)
arranhar - karãî
arranjar - rung (tr. irr.)
arrastar - ekyî (s)
arrastar-se - syryryk
arrebatar - ekyî (s)
arrebentar (tr.) - mombuk; mobok
arrebentar-se - puk; pok; bok
arredondar - moamandab ● arredondar, deixando esférico: moapu'a
arremessar - ityk / eîtyk(a) (t)
arrepender-se - moasy
arrependimento - moasy
arrepiar-se - nhemoatyrá
arrepio - tyrá
arrotar - eú (xe)
arruinar - moangaîpab; moingotebẽ; momoxy
articulação - (dos membros): îeapasaba; (dos dedos): pûapendaba (m)
árvore - ybyrá
asa - pepó (mb)
aspereza - korõîa
aspergir - ypyî (s); epyî (s)
aspergir-se - îeypyî
áspero - korõî
assado - (s.): mixyra; (adj.): mixyr
assaltar (= fazer ataque) - pu'am
assalto (= ataque) - pu'ama (m)
assar (na brasa) - esyr (s)
assassinar - apiti
assassino - poroapitîara (m) (v. apiti)
assento - apykaba
assim - (= desta maneira aqui): nã; (= dessa maneira aí): emonã ● assim que: upibé (r, s)
assoar-se (o nariz) - nheambubok
assustar - mosykyîé; mondyî
atacar - (tr.): epenhan (s); (intr.): pu'am
ataque - tepenhandaba; pu'ama
atar - tĩ, apytĩ ● atar as mãos a: popûar
atenção - (dar atenção): îeapysaká; (atenção!): tîaté!
atentar - îeapysaká
atirar - ityk / eîtyk(a) (t)
atolamento - pykûaba
atolar-se - pykûab (xe)
atoleiro - tuîuka
atrair - momotar ● atrair com iscas: monharõ
atrair-se - nhemomotar
atrás (de) - atuaî; akypûeri (r, s)
atrasar - moabaíb
através (de) - upi (r, s)
atravessar - asab (s)
audácia - kyre'ymbaba
audaz - kyre'ymbab
aumentar - irumõ
autêntico - eté (r, s)
avareza - tekoate'yma
avaro - ekoate'ym (r, s)
ave - gûyrá
avermelhado - pytang
avermelhar-se (= tingir-se de vermelho) - îemopyrang
avesso - py (mb)
avisar - momorandub ● avisar para reunião, para guerra: amanaîé
avó - aryîa 
avô - tamũîa; tamỹîa
avós (= os antepassados) - tamũîa; tamỹîa
axila - îybagûyra
azar - panema
azarento - panem
azedo - aî (r, s)
azia - pusu'umukaîa
azul (adj.) - oby (r, s); obyeté (r, s)

B

baba - tendysyryka
babar - endysyryk (r, s) (xe)
bacia - (e)nha'ẽ (r, s); nha'ẽ
baço - peré
bafo - timbora
bagre - (variedades): îundi'a, pirá-akãmuku, kuri, etc.
baía - kûá
bailar - poraseî
bainha - uru (r, s)
baixar (intr.) - gûeîyb
baixar (tr.) - mogûeîyb
baixo (rel. a som ou voz) - mbegûé
baixo (rel. a pessoa) - mirĩ
balançar - (tr.): moîatimung; (intr.): atimung
baleia - pirapu'ama
bambu - takûara
banana - pakoba
banco - apykapuku
bando - te'yîa
banhar - moîasuk
banquete (antropofágico) - pepyra (m)
barata - arabé
barba - tendybaaba
barco - ygara
barragem (para pesca) - pari
barriga - tygé
barro - nhau'uma ● barro branco: tobatinga; barro vermelho ou amarelo: tagûá
barulhento - pu; sunung
barulho - pu (mb); sununga
base - ypy; aŷpy 
bastante - eté; katu; katutenhẽ
bastar - apysyk (xe) ● basta!: aûîé! 
batalha - marana; marãtekó
batata-doce - îetyka
batedor (de pilão) - unguá
bater - (intr.): pûar; (tr.): pan; sok (-îo-); (bater com mão espalmada): petek
batizar - erok (s); mongaraíb
batizar-se - îerok
bêbado - sabeypora; kagûara
bebedeira - ka'u
beber - 'u (v.tr. irr.) ● beber cauim: ka'u; beber água: 'y'u
beberrão - kagûara
beiço (inferior) - tembé
beija-flor - (variedades): gûaînumby; gûarasyaba, etc.
beijar - pyter
beiju - mbeîu
beira - tembe'yba
beleza - poranga (m)
beliscar - pixam
belo - porang
bem (adv.) - katu; katutenhẽ ● bem feito!: îamuru! 
benzer - obasab (s)
bens - mba'e
benzer-se - îobasab
berne - ura
besouro - (variedades): mangangá, unaúna, etc.
bexiga - tyuru
bica (d'água) - 'ytororoma
bicar - pixam
bicho - v. animal
bico - tĩ
bigode - amotaba 
biscoito (indígena): miapé
bispo - abaregûasu
boca - îuru
bocejar - îeîurupirar
bochecha - tetobapé
bofetada - îoatypeteka
boi - tapi'irusu
boiar - bebuî
bola - apu'a; i moapu'apyra (v. moapu'a)
bolha - piru'a; kuruba ● bolha de ar na água: kamambu
bolor - tygynõ 
bolorento - ygynõ (r, s)
bolota - kuruba
bolsa - aîó
bom - angaturam; katu; marangatu
bondade - angaturama
bondoso - angaturam; marangatu
bonito - porang
boquiaberto - iurupukĩ
borboleta - panama
borbotar - bur; bubur
borda - tembé; tembe'yba
borrachudo - pi'ũ 
borrifar - epyî (s)
botar - v. por
boto - pukusĩ
braço - îybá
bradar - sapukaî
branco - ting ● homem branco, civilizado: karaíba
brancura - tinga
brando - pub
brandura - puba
branquear - moting
brasa - tatapynha
bravo - nharõ
brejo - uparana
brevemente - koromõ
briga - nhoepenhana
brigar - akab (v.tr.)
brilhante - berab
brilhar - berab
brilho - beraba
brincadeira - nhemosaraîa
brincar - nhemosaraî
brotar - enhũî (xe)
broto - amykyra
bulir - mỹî
buraco - kûara; puka (mb)
buscar - ekar (s)
buzina (= cornetim indígena) - îombyá
búzio - (variedades): gûatapy; sakurá; kupasy, etc.

C

cabeça - akanga
cabelo - 'aba
cabo - 'yba
caça - so'o
caçada - îeporakasaba (v. îeporakar)
caçador - ka'amondoara; ka'abondûara
cação - sucuri
cacarejar - nhe'eng
cachimbo - petymbûaba
cacho - taryba
cachoeira - ytu
cacique - morubixaba; tubixaba1
cada - îabi'õ
cadáver - te'õmbûera
cadeia - mundeoka
cadeira - apykaba
cair - 'ar; kuî ● cair com: ero'ar 
caixa - karamemûã
cajá - akaîá
caju - akaîu
calado - kyrirĩ
calar-se - nhe'endok; nhemokyrirĩ; pyk
calcanhar - pytá (mb) ● no calcanhar: pytáî
caldo - ty2; typûera
calo - piru'a (mb)
calor - takuba
calvo - 'akuîa; 'apytekuîa; 'apytereba
cama - kesaba; inimbeba
camarão - potĩ
caminhada - gûatá
caminhante - atara; ogûataba'e (v. gûatá)
caminhar - gûatá
caminho (em relação a quem passa por ele): (a)pé (r, s); (em relação ao lugar aonde ele leva): piara (mb)
campo - nhũ ● campo de batalha: maranaba (v. marana2)
cana-de-açúcar - takûare'ẽ
canal (para apanhar peixes) - pari
cana-ubá - u'ubá
canavial - takûare'ẽndyba
canela (parte do corpo) - tymãkanga
canindé - kanindé
canoa - ygara
cansaço - kane'õ; pûeraîa (mb)
cansado - kane'õ; pûeraî
cansar - mokane'õ
cansar-se - kane'õ (xe)
cantar - nhe'engar; (a ave): nhe'eng
canto (da casa, etc.) - koty
canto - nhe'engara; (de ave): nhe'enga
cão - îagûara; îagûamimbaba
capão (= ilha de mata) - ka'apa'ũ
capim - kapi'ĩ 
capivara - kapibara
capturar - îar / ar(a) (t, t); pysyk
cara - tobá
cará (var. de peixe) - akará
caracol - urugûá
caranguejo - (variedades): usá, gûanhumĩ, aratu, etc.
carapinha - akangapixa'ĩ
carga - posyîa
carícia (sensual) - nhomomoranga
carnaúba - karana'yba
carne - to'o; (de caça): so'o
caroço - kuruba; ta'ynha
carrancudo - esakûarasy (r, s)
carregar (= pôr carga em) - mombosyî
carta - papera (port.); kûatiara
carvão - tatapynha
casa - oka (r, s) ● casa na roça: kapŷaba
casado (s.) - mendara
casamento - mendara
casar (tr.) - momendar
casar-se - mendar
casca - apé; pé; pepûera; pira
cascavel (= var. de cobra) - mboîsininga
casco - pé; apé 
caspa (da cabeça) - 'apiku'i
caspa (do corpo, carepa) - piku'i
castanha (de caju) - akaîu-'akaîá; akaîutĩ
castigar - nupã
catinga - katinga
cativar - momiaûsub
cauda - tûaîa
cauim - kaûĩ
cauinar (= beber cauim) - ka'u
caule - 'yba
cavar - ybykoî (s)
caverna - ybykûarusu
cedo - esapy'a
cego - (adj.): ró; esab (r, s); (s.): abaesaba
cegueira - tesaúna
célebre - erapûan (r, s)
celestial - ybakygûar
centopéia - ambu'a
centro - (de coisa esférica): apytera; (de coisa plana): pytera ● no centro de, no meio de (coisa plana): pyteri
cera - iraîty
cerca - ka'aysá; ybyrá
cercado - tokaîa
cercar - aman; pîar (-îo-)
certamente - anhẽ; aûîeté; ipó; nipó; anheté; anhẽ serã
certeiro - pûakatu
cessar - (tr.): mombyk; (intr.): pyk
cessar (de) - po'ir
cesto - uru (r, s); panakũ ● cesto de taquara com tampa: karamemûã
céu - ybaka ● habitante do céu: ybakygûara
chama - tataendy
chamar - enõî (s) ● chamar para reunião: amanaîé
chamuscar - apek (s)
chamusco - pixé
chão - yby
chapéu - akangaoba
charco - 'yno'onga
chato - peb (v. peba)
chefe - tubixaba1; morubixaba
chegada - sykaba (v. syk1)
chegar - syk; (chegar com): erobasem; (por mar ou por rio): îepotar; (por terra): syk, gûasem ● chega! - aûîé!
cheio - ynysem (r, t)
cheirar - (intr.) - (cheirar bem): yapûan (r, s) (xe); (cheirar mal): yapûanusu (r, s) (xe); (tr. = sentir o cheiro de): etun (s)
cheiro - (cheiro bom): tyapûana; (cheiro de peixe): pyti'u; (cheiro de mofo): tygynõ; (cheiro de urina): taby'aka; (cheiro mau, bodum): katinga
cheiroso - yapûan (r, s)
chifre - 'aka
choça - tapyîa, tapuîa
chocalho - maraká
chocar (intr.): îoupi'aerub 
chorar - îase'o
choro - îase'o
choupana - tapyîa, tapuîa
chover - kyr
chupar - pyter; (os doentes, para arrancar-lhes a doença): suban
chuva - amana
cidade - tabusu
cigarra - îakyrana
cilada - koty
cintura - ku'a ● na cintura: ku'aî
cinza (de fogo) - tanimbuka
cio - tygûyrõ
cipó - ysypó
circular - amandab
círculo - amandaba
cisco - yty
ciúme - tygûyrõ ● ter ciúme: mondar
clara (de ovo) - tupi'atinga
claro - ting
coalhado - ypy'ak (r, t)
coar - mogûab
cobertura - aso'îaba
cobra - mboîa, moîa
cobrir - aso'i
cocar - akangatara
coçar - e'ỹî (s)
cócegas (fazer) - pokirik; mokyxyk 
cochilar - kerar
coco - inaîagûasu
coelho - tapiti
cogumelo - (variedades): karapuku; urupé, etc.
coisa - mba'e, ma'e
coitado (adj.) - poreaûsub
colar [1] (v.) - moîepotar
colar [2] (s.) - po'yra (m)
colega - tapixara
colher [1] (de pau) - ybyrapesẽ
colher [2] (v.) - yky; po'o
colocar - moín; mondeb; nong (-îo-)
com - (de companhia): esebé (r, s); ndi; ndibé; esé (r, s); irũnamo; irũmo; (instrumental): pupé
combate - marana
começar - ypy; ypyrung
começo - ypyrunga, ypyrungaba (v. ypyrung)
comer - (tr.): 'u; (intr.): karu ● comer gente: poru 
comida - tembi'u; i 'upyra (v. 'u)
comilão - karu
como - (de comparação): îá; îabé; (= na condição de): -(r)amo ● como... assim também; assim como... assim também: îabé... îabé
como? - marã îabépe? marãpe? marãngatupe?
cômodo - koty
compadecer-se (de) - aûsubar (s) 
compadre - atûasaba
compaixão - poraûsubara (m)
companheiro - atûasaba; irũ
completar - mopor; moaûîé
comprido - puku
compromisso - tekó
concepção - nhemonhangaba (v. nhemonhang)
concha - apé; itã
concluído - aûîé
concluir - mondyk
conclusão - mondykaba; sykaba (v. syk1)
concórdia - îoaûsuba
concubinato - agûasá
concubino (a) - agûasá
conduzir - erasó
confessar - mombe'u
confiar - îerobîar
conforme - upi (r, s)
confundir - erekorekó; moapaîugûá; moapatynã; monan; apamonan; mombe'uabaíb; mbo'eaíb
confuso - abaíb (v. abaíba)
conhecedor - kuapara (v. kuab)
conhecer - kuab
conhecido - kuabypyr (v. kuab)
conhecimento - tekokugûaba
cônjuge - me'engaba
consentir - moryb, mboryb
consertar - mongaturõ, mongatyrõ
consolar - moapysyk
consolar-se - apysyk (xe)
contar - mombe'u ● contar número ou quantidade: papar
conteúdo - pora
continuar - (intr.): îepotabẽ; (tr.): moîepotabẽ
continuidade - îepotabẽ
contra - supé
contrário (adj.) - obaîar (r, s)
convencer - moîesuer
conversa - nhomongetá, îomongetá
conversar (com) - mongetá
converter - erobak
convidar - so'o
convocar (para guerra ou reunião) - amanaîé
copular (= ter relações sexuais) - ikó / ekó (t) 
coqueiro - inaîagûasu
coração - nhy'ã; py'a
coragem - pyatã (mb); tekoeté
corajoso - kyre'ymbab; pyatã; ekoeté (r, s)
corda - sama ● corda para o sacrifício ritual, para amarrar o prisioneiro que será morto: musurana
corpo - teté1
correr - nhan
corrida - nhana
corrigir - enonhen 
cortado - asyk (v. asyka)
cortar - 'ab; mondok; (com instrumento cortante): kytĩ
coruja - (variedades): kaburé; îakurutu; suîndara, etc.
costa (de mar, de rio) - 'y rembe'yba
costas - aseîa; atukupé; kupé ● às costas: aseî; de costas - o atukupé pyterybo
costela - arukanga
costume - tekoaba
costumeiramente - îaby; amẽ
cotia - akuti
cotovelo - tendybangã; puraké
couro - so'oragûera
cova - kûara; ybykûara
covardia - abangaba; panema (m); membeka
covarde - abangab; panem; membek
covo - îeke'a
coxa - uba
coxo - parĩ
cozer - moîyb
cozido - mimõî [v. (e)mimõîa]
cozinhar - moîyb
crânio - akangapé
crença - terobîara
crepúsculo - 'are'yma
crer (em) - erobîar
crescer - kakuab
crespo - apixa'ĩ
cria - mimbaba
criado - mimbûaîa; boîá
criança - pitanga (m) 
criar - mongakuab
cristão - karaíba
crosta - pé
cru - pyr (v. pyra)
cruz - ybyrá-îoasaba; kurusá; îoasaba
cruzar - asab (s)
cuia - kuîa; kuîeté
cuidado - tesaetá
cuidar - angerekó; nhemosaînan
cume - apyra
cumieira - îapyrytá
cumprir - mopor
cunha - kasaba
cupim - kupi'ĩ
curado - pûerab
curandeiro - posanongara (m) (v. posanong) 
curar - mombûerab; posanong
curral - tokaîa
curto - akyta'ĩ; apûa'ĩ
curvar - apar
curvar-se - îeaŷbyk; nhemoapyr
cuspir - (tr.) mun (-îo-); endy; (intr.): nhenomum
cutucar - kutuk; pekãî

D 

daí - ebanõî
dali - ebanõî
dança - poraseîa (m)
dançar - poraseî
dar - me'eng 
de (rel. a origem, a procedência) - suí
debaixo (de) - gûyri; gûyrype
debulhar - yky
decididamente - ipó
declarar - mombe'u
dedo - (da mão): pûã (m); (do pé): pysã (m); (dedo indicador): pobe'engaba (m)
defecar - poti / epoti; ka'apîasó; ka'ab
defender - pîar (-îo-)
defensor - pysyrõana (v. pysyrõ)
defumar - motimbor
deixar - eîar (s) ● deixar de: po'ir
deleitar - moapysyk
delgado - po'ĩ
demônio - anhanga; îurupari; tagûaíba
demoradamente - puku
demorar - ikopuku / ekopuku (t)
denso - anam (v. anama)
dentada - tãîbora
dente - tãîa, tanha 
dentro (de) - pupé
denunciar - kuaukar
depois (de) - riré, iré ● depois disso: a'e riré
depressa - korite'ĩ; taûîé
derramar - en (-nho-s-)
derramar-se - nheen
derreter - moyku
derrotar - moaûîé
derrubar - mo'ar; ityk / eîtyk(a) (t)
desafiar - momburu
desaparecer - kanhem
descalçar-se - îepyaobok
descansar - putu'u
descanso - putu'u
descarregar - enosem
descascar - pe'ok; pin (-îo-)
descer - gûeîyb ● descer com; fazer descer consigo: erogûeîyb
descida (de morro) - teroapy'ambaba
descobrir - aso'îabok
desconhecido - kuabypyre'ym (v. kuab)
descrever - mombe'u
desde - abé; bé
desejar - potar
desejo - temimotara; (sensual): poropotara (m)
desembarcar - (intr.): pear; (tr.): enosem
desenhar - kûatiar
desenrolar - rab
deserto - tabe'yma
desgraça - poxy (m)
desgrudar-se - 'ir
desimpedido - aîereb (v. aîereba)
desinchar - rurunhyng 
desistir - apor (xe)
desligar - rab (-îo-)
deslizar - syryk
desmaiar - e'õ'ar (r, s) (xe); nhemote'õ'ar; manõaíb
desmanchar-se - apakuî
desobedecer - momarã
desonestidade - poxy (m)
desonrar - motĩbyk
despedir - mosem
despejar - en (-nho-s-); ekoabok; porok
desperdiçar - mombukab
despertar - (intr.): pak; (tr.): mombak
despido - ikatupe
despir - aobok
despovoado - tabe'ym (v. tabe'yma)
desprender-se - 'ir
desprezar - eroŷrõ
desprezível - aíb (v. aíba)
destampar - aso'îabok
desterrar - pe'a
destilar - mondykyr
destruído - tygûer (v. tygûera)
destruir - mombab; mondyk
desviar - eîyî (s)
detentor - îara
deter (= parar, retardar) - mombytá; mombuku
deterioração - poxy (m)
detestar - eroŷrõ; amotare'ym
Deus - Tupã
devagar - mbegûé ● devagarinho: mbegûé-mbegûé
devolver - moîebyr; eroîebyr; me'engyîeby
devorar - 'u
dia - 'ara
diabo - anhanga; îurupari
diante (de) - obaké (r, s)
dianteira (= vanguarda) - tĩapyra
diarréia - teîkûarugûy
difamar - îuru'ar (xe) 
diferenciar (= tornar diferente) - moingoé
diferir (= ser diferente) - ikoé / ekoé (t)
difícil - abaíb (v. abaíba)
dificultar - moabaíb
dilatar - oba'ok (s)
dilúvio - 'yporu
dinheiro - itaîuba
direita - 'ekatûaba ● à direita de: 'ekatûaba koty
dirigir (embarcação) - ebikok (s)
discípulo - boîá; temimbo'e
discutir - apore'ym (xe)
dispersar - mosasãî
distinguir - moingoé
dito (o que alguém diz) - 'esaba; 'îaba (v. 'i / 'é)
diversos - amõaé; amõ amõ
divertir-se - nhemosaraî
dividir - mbo'ir; moîa'ok
dizer - 'i / 'é
doador - me'engara (v. me'eng)
doar - me'eng
dobrar - moapyr; moakaar; apapûar
doce - e'ẽ (r, s)
doença - mara'ara; mba'easy
doente - (s.): mara'ara; mba'easybora; (adj.): mara'ar; mba'easybor
doer - asy (r, s) (xe)
doido (s.) - 'angaingaíba
dois (duas) - mokõî
dolorido - asy (r, s)
dono - îara
dor - tasy
doravante - angiré; ko'yré
dormir - ker ● dormir com; fazer dormir consigo: eroker
duramente - atã (r, s)
durante - pukuî; remebé
durar - ikopuku / ekopuku (t)
dureza - tatã
duro - atã (r, s)
dúvida - akasanga
duvidoso - akasang

E

eco - 'anga
efetivamente - nhẽ 
eia! (= vamos!) - ene'ĩ! enẽ!
eis (que) - kó; ikó; akó; iã; ã
eixo - agûeá2
ele(s; a, as) - a'e; ahẽ; i ● para ele: i xupé
elegante - matueté
elevado - ybaté
elevar-se - îeupir ● elevar-se com; fazer elevar-se consigo - eroîeupir
em - (rel. a lugar): -pe; -i; pupé; (rel. a tempo): esé (r, s)
emagrecer - nhemoangaîbar
embaixo (de) - (ponto preciso): gûyri; gûyrype; (sentido difuso): gûyrybo
embarcar - 'ar
embebedar - mondabeypor
embebedar-se - sabeypor
embelezar - momorang; moporang
embora (= apesar de que) - îepé; aûîebé-te; tiruã
embranquecer (tr.) - moting
embriagar - mondabeypor
embrulhar - pokek
emendar-se - nhenonhen
emergir - bur
emigrar - îeakasó
empalidecer - obaîub (r, s) (xe)
empanturrado - ebykatã (r, s)
empanturrar - moebykatã
empapar - moruru
emparelhado - amỹî
emplumar - amongy (s)
empobrecer - mondyabor
empoeirado - tubyr (v. tubyra); yî (v. yîa)
emprestar - poruukar
empurrar - moanhan
enaltecer - momba'eté; momorang
encalhar (navio) - îar
encaroçado - apaîugûá; apatynã
encaroçar (tr.) - moapaîugûá
enchente (do mar) - 'yura
encher - mopor; porakar; moynysem
encobrir - kuakub
encolher-se - nheŷnhang ● encolher-se (o pano): ponhea'ĩ 
encolhido (pano) - ponhea'ĩ
encomendar - pûaî (-îo-)
encontrar - gûasem; basem; obaîtĩ (s)
encostar - kok (-îo-)
encostar-se - îekok
encosto - kokaba
encruzilhada (do caminho) - pe-îoasapaba
encurralar - moîar
encurtar - apûapyk; mombeb; eŷnhang2 (s); moapûa'ĩ
encurvado - apar (v. apara)
encurvar - apar
endireitar - aparok
endurecer - moatã
enfeiar - moaíb
enfeitar - moîegûak
enfeitar-se - îegûak
enfeite - posanga (m)
enfeixar - man (-îo-); moapytam
enfiar - mondeb
enfileirar - moysyrung
enfim - irõ; te; ko'yté
enforcar - îubyk
enfraquecer - (intr.): membek; tumbek; (tr.): moatãe'ym; mopopyatambab
enfrentar (= fazer frente) - pytá
enfurecer-se - maramotar (xe); sapukaî2
enganar - erekomemûã; moaby
engano - tekomemûã
engolir - mokong
engordar - (intr.): nhemongyrá; (tr.): mongyrá
engrandecer (= tornar grande) - moeburusu
engravidar - momburu'a
engrossar - mopungá
enjoar (tr.) - moting
enjoativo - ting (v. tinga)
enjôo - tesagûyryba
enlameado - u'um (r, s) [v. u'uma (r, s)]
enojar-se - îegûaru
enorme - tubixab (v. tubixaba)
enquanto - remebé; pukuî
enraivecer - moabaîté
enraivecer-se - nhemoŷrõ2, îemoŷrõ2
enrolar - maman; apûapyk; mopokyrirĩ
enroscar-se - îekundab; îeapapûar
enrugado - apixa'ĩ 
ensanguentado - ugûy (r, s) [v. ugûy (t)]
enseada - kûá
ensinamento - mbo'esaba
ensinar - mbo'e
ensopado (s.) - mindypyrõ; temindypyrõ
ensurdecer - moapysakûaîe'o
entalhe - nhã; anhã2
então - ra'e; (= por ocasião disso): a'e-reme
enteado (a) - temirekó-membyra
entender - kuab; tekokuab; moang; py'arĩ
entendimento - 'ara; tekokuaba
enterrar - tym (-îo-)
entornar - (intr.): ẽ; (tr.): en (-îo-s-)
entorpecente (para peixes) - tingy; timbó
entortar - apar; moapẽ
entrada - teîké
entranhas - ybynha, ybỹîa
entrar - iké / eîké (t) ● entrar com; fazer entrar consigo: eroîké
entre (prep.) - pa'ũme
entregar - me'eng
entregar-se - nheme'eng
entristecer (tr.) - moingotebẽ
entristecer-se - nhemoingotebẽ
entupir (tr.) - 'o (-îo-)
envelhecer - kakuab1; nhemoaíb3
envelhecido - aíb (v. aíba); tuîba'e
envergonhado - mara'ar (v. mara'ara)
envergonhar - momara'ar; motĩ
envergonhar-se - tĩ
enviado - mimondó; paresara; temimondó
enviar - mondó
envoltório - ubandaba
envolver - aman; uban; pokek
enxada - syra
enxergar - epîak (s)
enxugar - monga'ẽ; mokang 
enxuto - aku'i; kang (v. kanga); aku'ixa'ĩ1; ka'ẽ
erguer - mopu'am; upir (s)
erguer-se - byr
erguido - byr
ermo (= desértico) - tabe'ym (v. tabe'yma)
erradamente - a'ub
errar - ikomemûã; aby
erva - ka'a
esbofetear - petek
esburacado - puk; pupuk; kûar (v. kûara)
escama - pé
escandalizar - moŷrõ; erekomemûã
escandalizar-se - îemoŷrõ2
escarrar - nhenomun; u'u (xe)
escola - nhembo'esaba
escolher - katu'ok
esconder - kuakub; mim (-îo-)
esconder-se - nhemim
escondido - nhemim ● às escondidas: nhemim
escorar - kok (-îo-)
escorregadio - sym (v. syma); syryk
escorregar - syryk
escorrer (um líquido) - syryk
escovar - abyky1
escravizar - momiaûsub 
escravo - temiaûsuba; miaûsuba; tapy'yîa
escrever - kûatiar
escurecer - (intr.): nhemopytun; (tr.): mopytun
escuridão - putumimbyka; putuna; putunusu
escuro - un (r, s) [v. una (t)]; pytun (v. pytuna)
escutar - endub (s)
esforçar-se - nhemoaîu; îeîukaaíb; nhemopyatã; kane'õ (xe); nhemoatã1
esfregar - kytyk
esfriar - moro'y
engasgar (tr.) - pytym
esgotado - pab (v. paba); kane'õ
esgotar (bebida ou conteúdo de vasilha) - moapy
esmagar - kumirik
esmurrar - atyká
espalhar - mosãî; mosasãî
espantado - putupab (v. putupaba)
espantar - mondyî
espelho - arugûá
esperança - îerobîasaba
esperar - ambé (só se emprega na 2a. p. s. do imper.: eambé! - espera!); arõ (s)
espetar - kutuk
espia - manhana
espiar - manhan
espiga - tara
espinha - (de peixe): kanga; (da pele): kuruba
espinho - îu; îuatĩ
espionagem - manhana
espirrar - atîam (xe)
espirro - atîama
esposa - temirekó
esposo - mena
espreguiçar-se - îepoká
espremedor (de massa de mandioca) - tepiti
espremer - amĩ
espuma - tyîuîa
esquecer-se - esaraî (r, s) (xe)
esquecimento - tesaraîa
esquentar - moakub; pé (-îo-)
esquentar-se - îepe'e
esquerda (s.) - asu
esse (a, es, as) - (vis.): ûĩ; ebokûeî; ebokûé; ebokûea; eboûî; eboûing; eboûĩba'e; eboûinga; (não vis.): a'e; aîpó; akó; akûeî
estalar (intr.) - pok; puruk; tirik
estar - ikó / ekó; kûab; kub ● estar com; fazer estar consigo: erokub; erekó; estar de pé: 'am; estar deitado: îub / ub(a) (t, t); estar deitado com: erub; estar em movimento: ikó / ekó (t); estar presente: ikobé / ekobé (t); estar sentado, parado, quieto: in / en(a) (t)
este (s, a, as) - ã; kó; ang; ikó
esteio - okytá
estender - poekyî; pysó; moatã; pirar
estender-se - nhemoatã2
esterco - tepoti
estéril (mulher, fêmea) - membyre'yma
estimar - amotar; aûsub (s)
estirar - moatã
estirar-se - nhemoatã; îepysó
estourar - (tr.): mobok; (intr.): pok
estouro - poka (m)
estrada - (a)pé (r, s)
estragado - aíb (v. aíba)
estragar (tr.) - moangaîpab; momoxy; moaíb; erekomemûã; moaikatu
estrago - poxy (m); paba (mb); erekomemûãsaba (t) (v. erekomemûã)
estrangeiro - maíra; atara; mamõygûaraé ● estrangeiro louro: aîuruîuba
estrela - îasytatá
estremecer - (intr.): syî; tumung; tytyk; (tr.): mondyî; mopiring; motumung
esvaziar - porok; mboapy
eternamente - aûîeramanhẽ
eu - ixé; xe
excitação - piringa; ara'a; (excitação sexual): tegûyrõ; aninga2
excitar - kapyrok; moaning; mopyring; pokyram
experimentar - a'ang (s)
expulsar - mombor
extinto - pûer
extremidade - tapûá; apyra

F

faca - kysé
faísca - piririka (m)
fala - nhe'enga
falador - nhe'engixûera
falar - nhe'eng
falhar - rambûer
falsamente - a'ub; tenhẽ
falsidade - a'uba
falso - a'ub (v. a'uba); memûã
faltar - mopanem; gûatar; por
fama - terapûana
família - anama; ta'yra
faminto - ambyasy
famoso - erapûan (r, s) [v. erapûana (t)]
fantasia - a'uba
farelo - ku'i
farinha - u'i ● farinha mole, farinha d'água, farinha puba, feita de certo gênero de mandioca, o aipim, amolecido em água durante vários dias: u'i-puba
farpa - arupare'aka
fartar - moapysyk
fartar-se - apysyk (xe)
farto - apysyk (v. apysyka)
fava - komandagûasu
fazedor - monhangara (v. monhang)
fazer - apó; monhang; ikó / ekó (t)
febre - takuba; akanunduka
febril - akanunduk (v. akanunduka)
fechar - moîar; 'o (-îo-) ● fechar com tranca: mopotãî; fechar a porta de: okendab (s) 
feder - nem (xe); kating (xe)
fedor - nema; katinga
fedorento - nem (v. nema); rem (v. rema); kating (v. katinga)
feijão - komandamirĩ
feio - poxy
feiticeiro - paîé (m)
feitiço - posanga (m)
feiúra - poxy (m)
feixe - mana
fel - py'aûpîara
felicidade - toryba; torypaba [v. oryba (t)]; tekokatu
feliz - oryb (r, s) [ v. oryba (t)]
fenda - puka (mb)
fender - (intr.): puk; (tr.): mobok
fender-se - bok ● fender-se em muitas partes: bobok
feriado - 'areté
ferida - pereba (m)
ferir - apixab; mopereb
feroz - poroîukaíb (v. poroîukaíba); kagûaíb (v. kagûaíba); marãmotar (v. marãmotara); nharõ1
ferro - itá
ferrugem - tepoti
ferver - (tr.): mopupur; (intr.): pupur
festa (ritual de comer e beber) - pepyra (m); nhemosaraîa
festejar - momorang
fezes - (e)poti (r, s)
fiar (= fazer fios) - poban
fibra - pó; tabiîu
fibroso - aîu (r, s); îyk (v. îyka)
ficar - pytá
fígado - py'a (mb)
fila - tysy
fileira - tysy
filha (de h.) - taîyra
filho (de h.) - ta'yra
filho(a) (em relação à mãe) - membyra
filhote (macho em relação ao pai) - ta'yra
filhote (fêmea em relação ao pai) - taîyra
filhote (em relação à fêmea) - membyra
fim - paba; papaba; sykaba 
finalmente - té; ko'yté
fincar - atyká
fingidamente - a'ub
fingido - a'ub; memûã; (nas palavras): nhe'engyrygûan(a)
fingir - mo'ang; mo'anga'ub; moran
fio - (e)nimbó (r, s)
firmar - moten
firme - atã (r, s); ten
firmeza - tatã
fixar - moten 
flauta - mimby
flecha - u'uba (r, s) ● flecha incendiária: tatá-u'uba
flechado - u'ubor(a)
flechar - ybõ
flor - potyra (mb); 'ybotyra
florescer - potyr (xe)
floresta - ka'a
florido - potyr [v. potyra (mb)]
focinho - tĩ
fogão - tataupaba
fogo - tatá
foice - îyapara
fojo (armadilha para animais) - ye'ẽ
fôlego - pytu (m)
folha - toba; ka'a
fome - ambyasy; matĩaré
fonte - nhãîa
fora - kûepe; mamõ
forasteiro - mamõygûara; atara
força - tatãngatu
formiga - (variedades): tasyba; ysá, akekẽ; arará, guaîu, etc.
formoso - aysó
formosura - aysó; poranga
forno - tapŷaba ● forno de fazer farinha: nha'ẽpesẽ2; nha'ẽpyúna
francês - maíra
frente - teseîa; tenondé2; tobaîa ● na frente de: eseî (r, s); obaî (r, s); obaké (r, s)
frequentar (= visitar frequentemente) - apekó (s)
frequentemente - îaby; py'i
frio (s. e adj.) - ro'y
fritar - moxyryryk
frito - i moxyryrykypyr (v. moxyryryk)
fronteira - tatobapy
frouxo - kué; membek (v. membeka)
frustrar - morambûer
frustrar-se - rambûer (xe)
fruta - 'ybá
fruto - 'ybá
fugido - kanhem; îabab
fugir - îabab; nhegûasem; kanhem ● fugir com; fazer fugir consigo: eroîabab
fugitivo - kanhembara; kanhembora; îabapara
fumaça - tatatinga; timbora
fumar - petymbu
fumegar - timbor
fumo (= tabaco) - petyma
fundo (= parte inferior) - gûyra; typy
furado - kûar (v. kûara)
furar - kutuk; mombuk
furar-se - puk
fúria - marãmotara
furioso - marãmotar (v. marãmotara)
furo - puka (mb); kûara 
furtar - mondá (xe); mondarõ2
furto - mondá; mondarõ3
futuramente - irã; mirã
futuro (adj.) - ram

G

gado - so'omimbaba
gafanhoto - tukura
gago - nhe'ẽrueru; nhe'engaíba
gaguejar - nhe'ẽrueru (xe)
gaiola - tokaîa
gaivota - (variedades): aty; gûakagûasu, etc.
galho - takã; takãpyra
galinha - gûyrasapukaîa
galo - gûyrasapukaîa
gambá - sarigûeîa
gancho - tyãîa
garça - gûyratinga
garganta - aseoka
gastar - mombab; mongûy
gastar-se - îarok; îearok; apakuî
gato-do-mato - marakaîá
gavião - (variedades): tagûató; karakará, etc.
geada - amanarypy'aka; ro'y-îukyra 
gema (de ovo) - apyteîuba
gêmeo - kõîa; kõîgûera
gemer - poasem (xe)
gemido - poasema (m)
gengiva - tãîbyra
gente - pref. poro- ● a gente: asé
geração - îeapyká; nhemonhangaba
gerar - poromonhang
girar - (intr.): îereb; îatiman; (tr.): moîereb
goela - aseoka
golpear - petek; apixab
gordo - kyrá
gordura - kaba ● gordura fora do corpo: kagûera 
gostoso - é (r, s)
gota - tykyra
governar - ekomonhang (s)
gozar - îekosub
gozo - morypaba (v. mboryb)
grande - eburusu (r, s); sufixos -usu, -ûasu, -gûasu 
grandemente - nãetenhẽ 
grandeza - teburusu
granizo - amanybá
grão - kuruba; ta'ỹnha
grávida - puru'a (m)
grelha - îurá; moka'ẽ
grenha - 'abebó
grilo - kyîu
gritar - asem (r, s) (xe); sapukaî
grito - tasema ● grito de guerra: posema (m)
grosso - poanam/a; anam/a
grudar - (tr.): moîar; (intr.): nhemoîar; pomong (xe)
grude - monga
guarda - morerekoara
guardar - arõ (s); erekó
guardião - tarõana; terekoara
guerra - marana; gûarinĩ ● ir à guerra: gûarinĩ-namo só
guerreiro - gûarinĩ; kyre'ymbaba
guia - 'yba
guiar - pokok; pekuabe'eng; erekó
gula - mba'e'ueteeté
guloso - karu

H

hábil - pokarugûar/a
habitante - pora; tekoara
hábito - tekoaba
habitualmente (= de costume) - amẽ
hálito - pytu (mb)
haver - i tyb (impessoal: há, havia); ikó / ekó (t); ikobé / ekobé (t)
hoje - (rel. ao tempo que ainda não chegou): kori; (rel. ao tempo já passado): oîeí; îeí
homem - (índio): abá; apŷaba; (negro): tapy'yîuna; (branco): karaíba; (em oposição a mulher): apŷaba; abá; (em oposição a animal bruto): abá
honrado - abaeté; eté (r, s)
honrar - moeté; momba'eté; moangaturam
horta - mityma; temityma
hospedar - mombytá
humilde - nherane'ym/a
humilhar - momboreaûsub
humilhar-se - nhemomboreaûsub

I

ida - só
idioma - nhe'enga
ignorância - tekokuabe'yma
ignorante - tekokuabe'ym/a
igreja - tupãoka
igual (a; igualha) - nungara
igualar - (tr.): moîoîab; (intr.): îakatu
igualar-se (= ser igual) - îakatu
ilha - 'ypa'ũ
iluminar - esapé (s); moendy
imagem - ta'angaba
imaginar - mo'ang
imediatamente - aûnhenhẽ
imenso - ubixab/a (r, s); katupabé; matueté
imigrar - îeakasó
imitar - a'ang (s)
impedimento - tarûaba
impedir - aru (s); moarûab
importunar - moaîu
imprestável - panem/a 
inchaço - ruru; pungá
inchar (tr.): mopungá; moruru; (intr.): pungá (xe); ruru (xe)
inclinação - apy'ama
inclinado - apy'am/a
inclinar - moapy'am
inclinar-se (para saudar): îeroky; (inclinar-se a cabeça): îeaŷbyk
incomodar - moaîu
índia - kunhã
indicar - kuabe'eng
indignar-se - îemoŷrõ
índio - (em oposição ao africano ou ao branco europeu): abá; (índio livre; índio da mata): apŷaba
infeliz - poreaûsub/a; panem/a
inferno - anhanga ratá
informar - momorandub
ingerir (comida, bebida, fumo) - 'u (v.tr. irr.)
inglês - aîuruîuba
íngreme - abaíb/a
-inho (suf. dimin.) -'i; -'ĩ 
iniciar - ypyrung; ypy
início - ypy; ypyrunga
inimigo - amotare'ymbara; tupîara; (inimigo de uma nação indígena, pertencente a grupo diferente, considerado hostil): tobaîara1; (inimigo pessoal): sumarã
injuriar - a'o; erekoaíb
injustamente - tenhẽ
injustiça - tekomemûã
inocente (s.) - marãtekoarûere'yma
insistir - îeîukaíb; apore'ym; apysá2 (xe)
instruir - motekokuab
inteiramente - gûetépe
intenção - tekopotasaba
intercalar - monhopa'ũmondoar; moîoparab; mopa'ũ
interessar-se - nhemoryryî; putupab (xe)
interior (s.) - py (mb); ybỹîa
interrogar - porandub
interromper - mopa'ũ
intervalo - pa'ũ; nhopa'ũ
intestino - tygeapûá
introduzir - moingé
inútil - panem/a
invejar (tr.) - moasy
inverno - ro'y
invocar - enõî(s); ekyî (s)
ir - só
ira - nhemoŷrõ
irar - moŷrõ; moabaeté1
irmã - (mais nova de m.): pyky'yra (m); (mais velha de m.) - tykera; (de h.): tendyra 
irmão - (de m.): kybyra; (mais moço de h.): tybyra; (mais velho de h.): tyke'yra
irritar - irarõ; monharõ
isca - potaba (m)
isso - a'e; akó; ûĩ; aîpó; eboûinga

J

já - (= logo): ra'a; (rel. ao passado): umã
jabuticaba - îabutikaba
jacaré - îakaré
jangada - ygapeba
jato - tororõma
jazer - îub / ub(a) (t, t)
jazida - tyba
jejuar - îekuakub
jejum - îekuakupaba
jibóia - îyboîa
joelho - tendypy'ã ● de joelhos: endypyãe'ybo
jogar (= lançar fora) - ityk / eîtyk(a) (t)
jorro - tororõma
juízo - tekokuaba
julgar - ekomonhang (s)
juntamente - abé; esebé (r, s)
juntar - mono'ong; eŷnhang (s); irumõ; moîepotar
juntar-se - nheŷnhang; îese'ar; îerobyk; îepotar
junto (de, a) - supé; pé; pyri
juntura - îepotasaba

L

lá - (vis.): ebapó; ûĩme; (não vis.): akûeîpe; a'epe
lábio - (inferior): tembé; (superior): apûã
laçar - îurar 
laço - îusana
ladrão - mondá; abá-mondá
lagarto - (variedades): teîu; teîugûasu; teîunhana; senemby; karapopeba; ameresyma; ameîuá, etc.
lago - upaba
lagoa - upaba; 'yno'onga
lágrima - tesa'y
lama - tuîuka; u'uma (r, s); ybyu'uma
lamaçal - tuîukusu
lamacento - tuîuk/a; u'um/a (r, s)
lamber - ereb (s)
lambuzar - mong
lamentar - eroîase'o; apirõ (s)
lampreia - karamuru
lança - mimbuku; itamina
lançar - ityk / eîtyk(a) (t); mombor
largar - mondó
largo - popeb/a; obeb/a (r, s); py
largura - popeba; peba; tobeba
latir - nhe'eng
lavar - eî (-îo-s-); moîasuk; (lavar roupa, batendo): patuká
lavoura - kopisaba; kó; 'ybapaara
lebre (do mato) - tapiti
legítimo - eté (r, s)
lei - tekó
leite - kamby
leito - tupaba
lembrança - ma'enduasaba (v. ma'enduar)
lembrar (tr. = fazer lembrar-se) - moma'enduar
lembrar-se - ma'enduar (xe)
lêndea - kyba'yra
lenha - îepe'aba
lentamente - mbegûé
lento - mbegûé
lepra - piraíba (m); piryty (m)
leproso - piraíb/a
levantado - byr
levantar - mopu'am; upir (s)
levantar-se - byr
levar - erasó
leve - bebuî/a
libertar - pysyrõ
ligeiro - apûan/a
limite - yby'îaba; sykaba
limo - 'ygûá
limpar - syb (-îo-); kytyngok; tybyrok
limpo - katu; (fal. de campo, de trilha, etc.): asym; pe'yb/a
língua - apekũ; (= idioma): nhe'enga
linha - (linha grossa): inimbó; (linha de pescar): pindasama; (linha fina de pescar): gûe'esama
líquido - ty2; tyku
liso - sym/a
listra - piriana (m) 
listrado (ao comprido) - pirian/a
livrar - pysyrõ
lixo - yty
lobo-guará - agûaragûasu
logo - aûnhenhẽ; korite'ĩ; koromõ; sapy'a; taûîé ● logo após, logo depois de: abé; logo então: a'ebé; logo mais: koromõ
lombada - asura; kandura
lombriga - sapoaîobaîa; teîkûatatina
longe - kûepe; mamõ
longo - puku
louco - angaingaíba
louva-a-deus - ka'aîara
louvar - mombe'ukatu
lua - îasy
luar - îasyendy
lugar - suf. -sab(a), -ab(a)
luta - marãtekó
lutar - marãmonhang
luxúria - poropotara (m)
luz - (do dia): 'ara; (luz de fogo, das estrelas, etc.): tendy
luzir - endy (r, s) (xe)

M

macaco - (variedades): ka'i; gûariba; mbyryki; sagûi; akyky, etc.
machado - îy
macho - sakûaîmba'e
machucar - apatuká; patuká ● machucar a cabeça de: 'apirungá
macio - pub/a
madeira - ybyrá
madrasta - sy'yra
madrugada - ka'amutuma ● de madrugada: ka'amutumo
maduro - (fal. de fruto): 'aîub/a; apaîé; 'apub/a
mãe - sy; a'i; (voc.: mãe!): a'i!
magro - angaîbar/a
mais - abé; bé; bé-no; abé-no; benhẽ
mal [1] (s.) - marã
mal [2] (adv.) - aíb/a; memûã
mal-cheiroso - ygynõ (r, s)
maldade - tekopoxy; marã; angaîpaba; poxy (m)
maldição! (interj.) - erĩ!
maldito - muru; moxy
maldizer - momburu
maltratar - apypyk; erekomemûã
mamar - kambu
manar - 'ẽ; 'em ● manar em borbotões: bur
mancha - pinima; paraba
manchado - parab/a; pinim/a
manco - parĩ
mandar [1] (= ordenar) - pûaî; ukar
mandar [2] (= fazer ir) - mondó
mandioca - mandi'oka 
maneta - (s.): asyka; (adj.): asyk
mangue - gûapara'yba; sere'yba
manhã - ko'ema ● de manhã - ko'ẽme
manso - by'ar; nherane'ym/a
mantimento - i 'upyra (v. 'u)
manto (de penas) - aso'îaba
mão - pó (mb) ● mão direita: 'ekatûaba
mar - paranã
maracá - maraká
maracujá - murukuîá
maravilhado - putupab/a
maravilhar - angerasó
marca - îekuapaba; (marca de pancada, de facada, de dentada): pora
maré - 'yura ● maré descendente, maré baixa - 'ysyryka
margem - tembé; tembe'yba
marido - mena
mas - a'e; -te
máscara - tobara'angaba
mastigar - su'u; su'u-su'u
mata - ka'a
matador - îukasara (v. îuká)
matança - îoapiti; paba (mb); porapiti (m)
matar - îuká
mato - ka'a
mau - aíb/a; memûã; poxy; angaîpab/a
me (pron. pess. obj.) - xe, ixé
mediano - boîá2
medicar - posanong
médico - poroposanongara (m)
medida - ta'angaba
médio - boîá; boîakatu
medir - a'ang (s)
medo - sykyîé; sykyîéba; (ter medo): sykyîé
medonho - abaîté
meio - ku'a; agûé; (meio de coisa esférica): apytera; (meio de coisa plana): pytera
mel - eíra; tyapira
melancia - 'ybae'ẽ; anhumatiroba
melancolia - pytubara (m); karukasy; aruru
melancólico - pytubar/a; karukasy; aruru
melhorar (da dor, da doença, etc.) - arybé (xe) 
menina - kunhataĩ
menino - kunumĩ
mensageiro - paresara; mimondó; temimondó
mentir - (e)mo'em (r, s) (xe)
mentira - (e)mo'ema (r, s)
mentiroso - temo'emiîara
mergulhar - (intr.): nheapumĩ; nhepumĩ; (tr.): pumĩ; 'apiramõ 
mesmo - aé; é ● nem mesmo: tiruã
mesquinho - a'ub/a
metade - ku'a
metal - itá
meu (s), minha (s) - xe
mexer - pukuî
mexerico - mba'epûera
mexer-se - mỹî
miar - nhe'eng
migalha - kurubipûera
milho - abati
mim - ixé, xe ● para mim: ixébe, xebe
mingau - minga'u
miserável - poreaûsub/a; tyabor/a
miséria - poreaûsuba (m); tyabora
miçanga - po'yra (m)
misturar - monan; moapatynã; moîese'ar; moîoparab; momemûã; apamonan
moça - kunhãmuku ● mocinha (de doze até quinze anos): kunhãmuku'ĩ
moço - kunumĩgûasu
modéstia - kunusãîa
modesto - kunusãî/a
modificar - ekoabok (s)
moer - mongu'i
mofado - ygynõ (r, s)
mofo - tygynõ
moita - ka'apûanama
mole - pub/a; membek/a
molhado - akym/a
molhar - moakym
molhar-se - nhemoakym
montanha - ybytyra
moquear (= assar sobre uma grelha) - moka'ẽ
moquém - moka'ẽ
morada - tekoaba
morador - tapiîara; tekoara; suf. -ygûar(a)
morar - ikó / ekó (t)
morcego - andyrá
morder - su'u
moreno (adj.) - pytang/a
morno - akubaíb/a (r, s)
morrer - îekyî; manõ / e'õ (t) ● morrer com; fazer morrer consigo: eromanõ
morro - ybytyra
mortandade - paba (mb)
morte - te'õ
mosca - (variedades): meru; mberuoby; îetinga; mutukusu, etc.
mosquito - (variedades): îati'ũ; marigûi; nhetingaruru
mostrar - kuame'eng; kuabe'eng 
mover - momỹî
mover-se - mỹî
mudar (tr.) - ekoabok (s); ekobîarõ (s)
mudar-se (de aldeia, de terra) - îeakasó; sem
mudo - nhe'enge'ym/a
mugir - nhe'eng
muitíssimos (as) - katupabẽ
muito (adv.) - eté; tekatu; katutenhẽ
muitos - e'yî (r, s); etá (r, s)
mulher - kunhã
multidão - te'yîa
multiplicar - irumõ; moetá; moîo'ar
mundo - 'ara
murchar - (intr.): nhynhyng; (tr.): monhynhyng
murcho - nhynhyng/a
murmurar - nhe'engaíb (xe); îuru'ar (xe)
música - nhe'engara
músico - nhe'engasara

N

nação - anama
nada - na mba'e ruã; (na neg.): mba'e
nadar - 'ytab
nádega - tebira
namorada - kunhã'yba
namorado - aba'yba
não - aan; aani; na... -i; na... ruã; umẽ; (referente a um fato futuro): aan umẽ-ne
nariz - tĩ
narrar - mombe'u
nascentes (de águas) - 'yapyra
nascer - 'ar1
nascimento - 'araba (v. 'ar1)
nata (do leite) - kaba2
navalha - marupá
navio - ygarusu
neblina - ybytinga
necessidade - tekotebẽ
negar - kuakub
negro - (adj.): un/a (r, s); (s.): tapy'yîuna
neném - pitangĩ
nervo - taîyka
neto (a) - (de h.): temiminõ; (de m.): tembiarirõ
névoa - ybytinga
nevoeiro - ybytinga
ninguém - na abá ruã; (na neg.): abá
ninho - tayty
nó - kytã; tesakytã; pokytã
noite - pytuna ● às noites, pelas noites, todas as noites, de noite: pytunybo; a noite toda, toda a noite: pysaré
noivo (a) - me'engaba
nojento - poxy
nojo - îegûaru; (ter nojo): îegûaru
nome - tera
nomear - enõî (s)
nora - (de h.): ta'yraty; (de m.): membyraty
nós - oré (excl.); îandé (incl.) ● a nós: orébe; orébo (excl.); îandébe; îandébo (incl.)
nos (pron. pess. obj.) - oré (excl.); îandé (incl.) 
nosso (s, a, as) - oré (excl.); îandé (incl.)
notícia - nhomongakugûaba; poranduba (m)
novamente - abé; bé; -no
novidade - poranduba (m)
novo - pysasu ● de novo: bé; benhẽ
nu - ikatupe
nuca - atuá
número - papasaba
numerosos - e'yî/a (r, s); etá (r, s); ypyó
nunca - a'an
nuvem - ybatinga; ybytinga

O

obedecer - apîar (s)
obra - temimonhanga; marãtekoaba
obrigar - ukar
obstáculo - tarûaba
obter - îekosub
oceano - paranãgûasu
ociosidade - tekotenhẽ
ocioso - ekotenhẽ (r, s)
oco - (s.) ybỹîa; (adj.): ybyî/a
ocultar - kuakub
ocultar-se - îekuakub
odiar - amotare'ym; eroŷrõ
ódio - amotare'yma
oeste - kûarasy reîkeaba
ofegante - aŷbu
ofegar - aŷbu (xe)
ofender - erekomemûã
ofender-se - nhemoasy
oferecer - kuabe'eng; erekûab
oferenda - îetanongaba
oh! (interj.) - mã!; (de h.): gûé!; gûy! (de m.): îu!; îó!
óleo - îandy 
olhar - ma'ẽ
olheira - tesagûyrumbyka
olho - tesá
ombro - ati'yba
onça - îagûara; îagûareté
onda - ygapenunga (r, t)
onde? - mamõpe? umãmepe? umãpe? ● de onde?: mamõ suípe?
ontem - kûesé
oposto - (adj.): obaîar/a (r, s); (s.): obaîara(t)
oprimir - apypyk; pyk (-îo-)
oração - îeruresaba
ordem - tekomonhangaba
ordenar - ekomonhang (s); pûaî (-îo)
orelha - nambi
órfão - (de mãe): sye'yma; (de pai): tube'yma
orgulho - porerobîare'yma1 (m)
orgulhoso - porerobîare'ym/a 
orientar - ekomonhang (s)
origem - 'yba; ypy; ypyrunga
ornar - moîegûak
ornar-se - îegûak; îemongatyrõ 
osso - kanga
ostra - reri
ótimo - matueté
ou (conj.) - konipó; koîpó
ouro - itaîuba
outro (s; a; as) - amõaé; amõ
outrora - erimba'e
ouvido - apysá
ouvir - endub (s); apysá (xe)
ova (de peixe) - tuba2
ovo - tupi'a
oxalá - temo! mã!

P

paca - paka
paciência - osanga (t)
paciente - osang/a (r, s)
pacífico - by'ar; nhyrõ (xe)
padrasto - symena
padre - abaré
padrinho - porerokarûera (m)
pagamento - tepy
pagar - epyme'eng (s); moepy
pai - tuba2
pajé - paîé (m)
palavra - nhe'enga
pálido - obaîub/a (r, s)
palmeira - (variedades): pindoba; tukũ; pati; pysandó; îeîsara; inaîá; karaná; îupati; maraîa'yba; karana'yba, etc.
palmito - u'ã
pálpebra - topé
palpitar - tytyk
pântano - tuîuka
pão - miapé
papa - minga'u; mindypyrõ; temindypyrõ
papada - tendybagûyaîa
papagaio - (variedades): aîuru; anaká; tiriba; îandaîusu; îendaîa; îuruba, etc.
papo - aîa; îurubyra; tendybagûyra
para - (lugar): -pe; (pessoa) - supé; pé
parar - (= cessar): pyk; (= estacionar): pytá ● parar de: po'ir
pardo - pytang/a
parecer - berame'ĩ
parecido - abŷare'ym/a
parede - pyá; opyá (r, s)
parente - mũ
parir - membyrar (xe)
partir [1] (= quebrar) - mondok; pese'õ
partir [2] (= ir embora) - po'ir
parto - membyrara; membyrasaba (v. membyrar)
passagem - tasapaba [v. asab (s)]
passar - (intr.): kûab; (tr): asab (s)
pássaro - gûyrá; (passarinho): guyra'ĩ
passear - îebyîebyr
pasto - karûaba
pato - ypeka
pátria - tetama
pau - ybyrá
pau-brasil - ybyrapytanga
pé - py (mb)
pecador - angaîpabora
peçonhento - tegûam/a; anhasy (r, s)
pedaço - pesembûera; asyka; asykûera
pedido - îeruresaba (v. îeruré)
pedir - îeruré
pedra - itá
pedregulho - itakurubi
pedreira - itatyba (v. itá)
pegada - takypûera; pypora (mb)
pegajoso - mong/a 
pegar - îar / ar(a) (t, t); pysyk
peito - poti'a (m)
peixe - pirá
pejagoso - pomong/a; mong/a
pelado - apin/a
pelar - abo'o (s)
pele - pira (mb)
pelo - taba
pena - saba [v. aba (s, r, s)]
penca - pema2 (mb)
pendurado - îasekó
pendurar - moîasekó
peneirar - mogûab
peneira - urupema
pênis - takûãîa
pensamento - py'anhemongetá (m); îemongetá; 'anga
pensar - mo'ang
pente - kygûaba
pentear - abyky
pentear-se - îeabyky
pequeno - mirĩ; a'yrĩ (r, t)
perante - obaké (r, s)
perceber - andub
perdão - nhyrõ
perder (= fazer sumir) - mokanhem
perder-se - (= extraviar-se): opar (r, s) (xe); (= sumir): kanhem
perdido - kanhem/a
perdoar - nhyrõ (xe)
peregrino - atara
pergunta - poranduba (m)
perguntar - porandub
periquito - (variedades): anakã; tu'ĩ; tu'ĩtyryka, etc.
permanecer - pytá
permitir (= não se importar com) - epîakĩ (s)
perna - tetymã
pernilongo - nhati'ũasu
peroba - yperoba
perseguidor - piara (mb)
perseguir - momosem 
perto - mbype; (perto de): pyri; ypype
perverter - moangaîpab
pesado - posyî/a; anam/a
pescador - îeporakasara (v. îeporakar); pindaîtykara
pescar - (tr.): ekyî (s); (intr.): pindaeîtyk; (pescar com rede): îeporakar
pescaria (com rede) - îeporakasaba (v. îeporakar)
pescoço - aîura ● no pescoço: aîuri
peso - posyîa (m)
pessoa - abá
pestana - topeaba
pião - pyryryma (m)
piar - nhe'eng
pica-pau - ipekũ
picar - kutuk
pico - tapûá
pilar - sok (-îo-)
pimenta - ky'ynha
pingar - tykyr (xe)
pinta - pinima (m); pitinga
pintado (= que tem pintas): pinim/a; piting/a; (= que tem pintura): kûatiar/a 
pintar - kûatîar; (pintar de branco): moting; (pintar de vermelho): mopyrang; (pintar de preto): moún; (pintar de amarelo): moîub
pintar-se - îegûak; (pintar-se de vermelho): îemopyrang; (pintar-se de preto): îemoún
pio - nhe'enga
piolho - kyba
piranha - pirãîa, piranha
pirilampo - mamûá
pisar - pyrung
piscar - nhemoesabyk (r, s) (xe); sapumim
pitanga (= var. de planta mirtácea) - 'ybapytanga
planta [1] - 'yba
planta [2] (dos pés) - pypytera (m)
plantação - (e)mityma (r, s); mityma
plantar - (tr.): tym (-îo-); (intr.): mba'etym
pó - ku'i; tybyra
pobre - mba'ee'ym/a
pobreza - mba'ee'yma
poça - 'yno'onga
poção - posanga (m)
poço - 'ykûara
poder [1] (s.) - tatãngatu; 'ekatu
poder [2] (v.) - 'ikatu / 'ekatu
podre - îuk/a; aíb/a; tuîuk/a
podridão - îuka; tuîuka
poeira - tubyra; ybytimbora
pois - irõ; rõ
poleiro - kesaba; tendaba
polpa (de fruta) - to'o
polvo - kaîakanga
pólvora - pokaku'i (m)
pomba - pykasu
ponta - tapûá; apyra ● na ponta de: apyri
ponte - nharybobõ
pontiagudo - atîaî/a (r, s)
pontudo - atîaî/a (r, s)
por - (= através de): upi (r, s); (= por causa de): suí; -reme; esé (r, s); ri
por (v.) - moín; mondeb; nong (-îo-); rung; (pôr em pé): mo'am; (pôr deitado): moúb
porção - potaba (m)
porco - (porco-do-mato): taîasu; (porco doméstico): taîasugûaîa
porém - a'e
porque - -reme
porta - okena (r, s); okendaba (r, s) ● abrir a porta: okendabok (s)
portador - îara
portanto - emonãnamo; irõ; ra'e; rõ
porto - peasaba
português - peró
porventura - nipó; (na interr.): iã? ipó? -pipó?
possuir - erekó
pote - kamusi; ygasaba
poucos - mokonhõ; mboby
pousada - pytasaba (m)
pouso - tendaba
povo - anama
povoação - taba
praça - okara
praia (de mar ou rio) - 'yembe'yba; 'yembiîeîa
prantear (alguém que morreu ou alguém que chega, como forma de saudação) - apirõ (s)
praticar - poru
prato - (e)nha'ẽ (r, s)
preço - tepy
precursor - tenotara
preencher - esemõ (s); mopor
preferir - potarĩ
pregar (= fixar com pregos) - moîar
preguiça - ate'yma
preguiçoso - ate'ym/a; ekotenhẽ (r, s)
prejudicar - moingotebẽ; momarã
prender - pysysk
prenhe - puru'a
prensa (para retirar o sumo de plantas) - tepiti
preocupado - putupab
preocupar-se - nhemoryryî; nhemosaînan
preparar - rung 
presa - tembiara
presente (= dádiva) - îetanongaba
presentear - îetanong 
pressa - tanhẽ 
prestes (a) - apyrĩ
pretejar-se (= pintar-se de preto) - îemoún
preto - un/a (r, s)
prezar - amotar
prima - (de h.): tendyra; (de m.): tykera (quando mais velha); pyky'yra (quando mais moça)
primeiro - (adj.): ypy; (adv.): ranhẽ
primo - (paterno de h.): tybyra (quando mais moço); tyky'yra (quando mais velho); (de m.): kybyra
prisioneiro (de guerra) - pu'amagûera (m)
proceder - ikó / ekó (t)
procurar - ekar (s)
professor - mbo'esara; porombo'esara (m)
prometer - mombe'u; momboî; kuabe'eng; kuambe'u; enõî (s)
pronto - aûîé; ekoaûîé (r, s)
pronunciar - a'ang (s)
prostituição - sygûaraîy
prostituta - sygûaraîy; kakuabe'yma; patakûera
proteção - tarõaba [v. arõ2 (s)]
proteger - arõ2 (s)
provar - a'ang (s)
provavelmente - ipó re'a; serã; ruã
prover-se - nhemosaînan
provocar - monharõ; monheran
publicamente - te'yîpe; ikatupe
pular - por; popor
pulmão - nhy'ãbebuîa
pulso - papy
punir - erekomarã
pupila - tesa'yra
purgante - posanga (m)
puro - oîeperemõ
pus - peú
puxar - ekyî (s); (puxar por corda): samysyk; motyk

Q

quadril - tenangupy
qual? - marãpe? mba'epe? umãba'epe? (quais?): marã-marãpe? mba'e-mba'epe?
qualquer (quaisquer) - tetiruã
quando [1] (= por ocasião de) - reme
quando? [2] - (referindo-se ao futuro): moîrãpe?; (referindo-se ao futuro ou ao passado): erimba'epe?; (= em que ocasiões?, referindo-se a fatos habituais): marã-nemepe?
quanto? - nãbo? nãmo? mobype?
quantos (as)? mbobype? mobype? ● quantas vezes?: mbobype?
quarto (num. ord.) - oîoirundyka
quase - só; sûer
quatro - oîoirundyk
quê? (= que coisa?): mba'epe? marãpe? (referindo-se a mais de um): mba'e-mba'epe? marã-marãpe ● que mais?: mba'epe amõ? de quê?: mba'e suípe?; com quê?: mba'e pupépe?; por quê?: mba'e resépe? (com sentido futuro): mba'erama resépe? mba'erama ripe?
quebrar (tr.) - ká (-îo-); mopen; mondok; mombuk; monarang ● quebrar a cabeça de: akangá
quebrar-se - îe'ab; îeká; pen2; sok
queda - gûyapy1; kuîa (v. kuî); 'araba (v. 'ar4)
queimar - (tr.): apy (s); (intr.): kaî
queixar-se - (intr.): nhemoŷrõ; (tr.): mombe'u
queixo - tendybá; taîyba
quem? - abápe? (referindo-se a mais de uma pessoa): abá-abápe? ● de quem? (ref. a origem, a procedência): abá suípe?; para quem?: abá supépe?
quente - akub/a (r, s)
querer - potar; seî (só com temas verbais incorporados)
quieto - arybé; (= silencioso): kyrirĩ ● ficar quieto (= ficar tranquilo): by'ar; ikonhote
quotidiano - 'ara îabi'õndûar/a

R

rã - (variedades): îu'i; tataka; kotorá, etc.
rabo - tûaîa
raça - anama; ta'ysé
rachadura - 'apaba (v. 'ab); boka
rachar - (intr.): bok; (tr.): mobok
raio - tupãberaba
raiva - nharõ; îemoŷrõ
raiz - sapó [v. apó (s, r, s)]
ralar - eé (s)
ramo - takã
ranger (tr.) - mongyrỹî 
rapado - apin/a
rapar - pin (-îo-) ● rapar a cabeça de: 'apin
rapaz - kunumĩgûasu
rapidamente - korite'ĩ; taûîé
rápido - (adj.): py'i; apûan/a (adv.): sapy'a; esapy'a; korite'ĩ
raro - kûaî/a; pokang/a; etapokang/a (r, s)
rasgar - mondorok
rasgar-se - sorok
raso - apererá; peb/a; aîereb/a
rastro - takypûera; pypora
rato - (variedades): gûabiru; punaré; karukuoka, etc.
realizar - mopor
realmente (= de verdade, na verdade) - anhẽ
rebentar - (intr.): bok; pok; puk; (tr.): mobok; mombuk
recear - posykyîé; poûsub; eroangu; eronheangu
receber - îar / ar(a) (t, t)
recente - pysasu
recipiente - uru (r, s); (em relação à pessoa que o leva): (ep)uru (r, s)
recolher - eŷnhang (s)
recompensar - moepy
reconciliar - moîerekûab; monhemũ
reconhecer - kuab
recuar - îeakypûereroîebyr; syî; syryk
recusar - kuakub; poûsub
rede [1] (de dormir) - inĩ
rede [2] (de pesca) - pysá; (rede para apanhar camarões, jereré) - îareré
redondo - (esférico): apu'a; (circular): amandab/a; apỹî/a
refém - porepy1 (m)
reformar - ekonongatu (s); ekomonhangab (s)
regar - ypy (s); amõ; 'apiramõ
região (= terra em que se habita) - tetama
relâmpago - amãberaba
remar - (tr.): pukuî; (intr.): ygapukuî 
remédio - posanga (m); posanongaba (m)
remendar - 'o (-îo-)
remo - ygapukuîtaba
repartir - moîa'ok ● repartir em pedaços - pyse'ong; pese'õ
repentinamente - sapy'a; esapy'a
repetir - eroîebyr; momokõî
repreender - enonhen
resfolegar - aŷbu (xe)
resgatar - epyme'eng (s)
resgate - tepy
resistir - (intr.): nheran; nhemobabak; (tr. - resistir a): momarã; popyatã; moabangab2
resmungão - kuruk
resmungar - kuruk; kururuk
respeitar - moabaeté; motyb
respirar - pytu (xe)
responder - obaîxûar (s); nhe'eng; nhe'ẽpoepyk
resposta - po'epykaba (m); nhe'enga
restituir - epy (s)
retalhar - mbo'ir; mondosok
retardar - mombuku
retirar - enosem
reto (= direito) - atã (r, s)
retorcer - mopokyrirĩ; poká
retribuir - (intr.): îepyme'eng; (tr.): poepyk
reunir - mono'ong; eŷnhang (s)
revelar-se - îepîakukar
revidar - poepyk
revirar - pobur; poekar
revirar-se - îepubur; îereb
rezar - îeruré; tupãmongetá 
riacho - 'ye'ẽkûaba; 'yekûabusu
rim - pyrykytỹ'i (m)
rio - 'y; ty2; îy
riqueza - mba'e
rir - puká
riscar - aír (s)
roça - kó; 'ybapa'ara
roçar - (intr.): kopir; (tr.): gûyrok
rodar (intr.) - nhatiman; pararang; (rodar como pião): pyryrym 
rodopiar - pyryrym
rodopio - pyryryma (m)
roer - karãî
rogar - îeruré 
romper - mondorok; ká (-îo-)
romper-se - sorok; bok; îepirok; puk
roncar - ambu (xe)
rosto - tobá
roubar - mondá (xe); mondarõ
roubo - mondá
rouco - îase'opyoú; nhe'ẽpyoú
roupa - aoba
ruga - nhynhynga
ruim - aíb/a; memûã; poxy
rumo (a = na direção de) - koty

S

sabedor - kuapara (v. kuab)
saber - kuab ● sei lá!: sé!
sabiá - sabîá
sabor - té; te'ẽ 
saboroso - é (r, s)
saco - aîó
sagrado - karaíb/a
saída - sema
sair - sem
sal - îukyra
salgado - e'ẽ (r, s)
salgar - moe'ẽ
saliva - tendy
saltar - pererek; por
saltitar - pererek
salto - pora
salvar - pysyrõ
sangue - tugûy
santificar - mongaraíb
santo - karaíb
sapé - sapé
sapecar - apek (s)
sapo - kururu
sarar - pûerab
sarna - kuruba; piremonã (m)
saudades - tepîaka'uba ● ter saudades de: epîaka'ub (s)
saúde - marane'yma
se [1] (índice de indeterminação do sujeito) - gûá; ybá; ybŷá
se [2] (= no caso de): -reme
se [3] - (pron. recipr.): -îo-; (pron. reflexivo): -îe-
secar - (intr.): tining; (tr.): motining; monga'ẽ 
seco - aku'i; ka'ẽ; tining
sede - 'useîa
sedento - (s.): 'useîbora; 'useîbor/a
seguir - (intr.): gûatá; kuabĩ; (tr.): mosẽmosem; akypûembour (s); akypûemomosem (s); akypûemondó (s) 
segundo [1] (= de acordo com) - upi (r, s)
segundo [2] (num. ord.) - mokõîa
segurar (com as mãos) - pysyk
seio - kama
sem - -e'ym (suf.); suí
semelhante - abŷare'ym/a
sêmen - ta'yra
sempre - ko'arapukuî; îepi (nhẽ); memẽ; memẽ îepi ● para sempre: aûîeramanhẽ
senhor - pa'i; îara
senhora - îara
sensual - poropotar/a
sentar-se - gûapyk
sentir - andub
separar - pe'a; mbo'ir; mombo'ir
separar-se - 'ir; îa'ok; po'ir; sandok
sepultar - tym (-îo-)
sepultura - tyby
sequer - tiruã
ser - ikó / ekó (t)... -ramo
serra [1] (= conjunto de montanhas): ybytyrusu; ybytyra
serra [2] (= instrumento de serrar) - ybyrakytĩaba
servir - erokûab; (servir bebida): e'ym (s)
seu (s, sua, s) - i; s; t-; (seu próprio): o; og; ogû; oû
silêncio - kyrirĩ
silencioso - kyrirĩ
sim - (de h. e m.): eẽ; (de h.): pá
sinal - ta'angaba; îekuapaba; pora (mb)
siri - seri; siri
só (adj. ou adv.) - anhõ; (adv.) - nhõ
soar - pu (xe); yapu (r, s) (xe); pong
sob - (ponto preciso): gûyri; gûyrype; (sentido difuso): gûyrybo 
sobra - tembyra
sobrancelha - tybytaba
sobrar - embyrûer (r, s) (xe) (v. tembyra); (sobrar a alguém): esemõ (s) 
sobre - (ponto preciso): 'ari; sosé; (sentido difuso): 'arybo 
sobrinha - (filha do irmão ou primo de h.): taîyra; (filha da irmã ou prima de h.): îetypera; (filha do irmão ou primo de m.): penga (m); (filha da irmã ou prima da m.): tykera (quando mais velha), piky'yra (quando mais moça) 
sobrinho - (filho do irmão ou primo de h.): ta'yra, tyky'yra2 (quando mais velho); (filho do irmão ou primo de m.): penga (m); (filho da irmã ou prima de m.): i'yra
socador - unguá
socar - sok (-îo-)
socorrer - pysyrõ
sofrer - porará ● sofrer dor: asy (r, s) (xe)
sofrimento - poreaûsuba (m); porarasaba (v. porará); nhenupãsabusu
sogra - (de h.): taîxó; (de m.): mendy
sogro - (de h.): tatu'uba; (de m.): menduba 
sol - kûarasy; kûara
sola (do pé) - pypytera (mb)
solo - yby 
soltar - mosem; erab
soltar-se - 'ir
solteiro - mendare'yma
soluçar - îeîok/a (xe)
soluço - îeîoka
som - pu (mb)
sombra - 'anga
somente - anhõ; nhõte
sonhar - posaûsub
sonho - posaûsuba (m)
sono - topesyîa ● estar com sono: opesyî (r, s) (xe)
sonolento - opesyî/a (r, s)
sonoro - sunung/a; pong/a
soprar - py (-îo-)
sorrir - pukamirĩ
sossegado - pyk; osang/a (r, s)
sossegar (intr.) - apysyk/a (xe); arybé (xe); pytuẽ (xe); nhemoapysyk; nhemongatu
sossego - pyka (mb); apysyka; tekokatu
sozinho - anhõ; nhote; (adv.) - anhõ
suar - yaî/a (r, s) (xe)
subir - îeupir ● fazer subir consigo; subir com: eroîeupir
substância - teté1
substituir - ekobîarõ (s)
substituto - tekobîara
suco - typûera
suficiente - oîá; oîakatu
sugar (os doentes, para arrancar-lhes a doença) - suban
sujar - mongy'a; mong (-îo-)
sujeira - ky'a
sujo - ky'a; u'um/a (r, s)
sumir - kanhem
suor - tyaîa
superfície - apé
suportar - porará
surdo (s.) - apysae'yma; apysakarara 
surpreender (= apanhar de surpresa) - pokosub
suspeitar - andub ● suspeitar mal de: mondar2
suspender (= pendurar) - moîasekó
suspirar - nheangerur
sustentar - poî (-îo-)

T

tabaco - petyma
tábua - ybyrapeba
tacape - ybyrapema
tagarela (s.) - nhe'engixûera
talha (de fazer cauim) - ygasaba
talvez - nipó; serã; (na interr.): ipó?
tamanduá - tamandûá
também - abé; bé; -no
tambor - gûarará
tapar - aso'i; obapytym (s)
tapuia - tapy'yîa
taquara - takûara
tarde - karuka ● de tarde: karúkeme
tartaruga - (variedades): îurukûá; îurará; 'ygûara; uruana, etc.
tatu - tatu
tear - ytá
tecer - pyasab; pẽ (-îo-)
temer - poûsub; sykyîé
tempestade - amanusu (v. amana)
tempo (= as condições atmosféricas) - 'ara
tentar - a'ang (s)
ter - erekó
terceiro - mosapyra
terminar - pab
terra - (em seu aspecto físico, natural): yby; (no sentido de pátria): tetama
terreiro (entre as ocas) - okara
terrível - abaeté
terror - abaeté
testa - sybá
teu (s, tua, s) - nde
tia - (paterna): aîxé; (materna): sy'yra
tigela - nha'ẽpygûaîa; temiuru; nha'ẽpyko'ẽ
tingir - (com urucu): gûang (-îo-); (de preto): moún; (de amarelo): moîub; (de vermelho): mopyrang; (de branco): moting
tio - (materno): tutyra; (paterno): tuba2
tipóia - typoîa
tirar - 'ok (-îo-); eno'ẽ; mbo'ir
toca - kûara
tocar [1] (instrumento) - (de sopro): py (-îo-); mimby; (de percussão): mopu
tocar [2] - (tr.): atõî; (intr.) byk; (= passar a mão): pokok
todo (s, a, as) - opab, opabẽ, opabẽngatu, opabenhẽ, opabĩ, opabinhẽ, opakatu; pab
tomar - îar / ar(a) (t, t)
tonto - esagûyryb/a (r, s)
tontura - tesagûyryba
topete - tetobapy
tora - topytá
torcer - (tr.): pepyr; poká; (torcer como corda): pomombyk; (torcer mão ou pé): mongaraû; (intr.): îekundab; îe'ab; (mão ou pé): nhemongaraû
tornozelo - pynhûãkanga (m) 
torrar - a'embé (s)
torto - apar/a; bang/a; apen/a
tortuosidade - apara; banga; apena
tosar - moapererá; apin
tosquiar - apin; akarãî
tosse - u'u
tossir - u'u (xe)
tostado - ka'ẽ 
totalmente -pab
trabalhador (s.) - marãtekoara
trabalhar - porabyky; (trabalhar em grupo): potyrõ
trabalho - marãtekó; marãtekoaba; porabyky2 (m)
traça - ysokapé
trair (o cônjuge) - mondarõ
trançar - pẽ (-îo-)
transbordante - ynysem/a (r, t)
transbordar - (intr.): tuî; (tr.): monduî
transformar - monhang
transgredir - aby
tratar - erekó
travar (tr.) - mombyk; moten
trazer - erur
tremer - ryryî
tremor - ryryîa
trêmulo - ryryî/a
trepar - îeupir 
três - mosapyr
triste - aruru
tristeza - angekoaíba; aruru; tekotebẽ
troco (= o que se dá em troca) - tepy
trombeta - (variedades): mimbygûasu; itamimby; mimbyapara; nhumbugûasu
tronco (de árvore): ypy ● tronco cortado: topytá
tropeçar - pysakang/a (xe)
trovão - tupã; amãsununga; tupãsununga
trucidador - apitîara (v. apiti)
trucidar - apiti
tu - ne, nde, endé; îepé ● para ti, a ti: ndebe, endébe; ndebo
tubarão - iperu; yperu
tucano - tukana
turvar (a água de) - mo'ypiting

U

uivar - nhe'eng
ultrapassar - pûan (-îo-)
um (a) (num.) - oîepé ● à uma, em uníssono: oîepegûasu (v. oîepé)
umbigo - puru'ã (m)
umidade - ty2; yby'y; akymaíba
úmido - akymaíb/a; y (r, t); yby'y (r, s)
unha - (da mão): pûapẽ (m); (do pé): pysãpẽ (m) 
unhada - pûapẽmbora (m)
unir-se - îese'ar 
untar - mongy; pitub; pixyb; kytyk
urina - ty
urinar - karuk
urrar - nhe'eng
urro - nhe'enga
urubu - urubu
usar - poru, puru
útero - pitãnhemonhangaba (m)

V

vadiar - ikotenhẽ / ekotenhẽ (t)
vadio - ekotenhẽ (r, s)
vagalume - mamûá
vagem - topé
vagina - tapupira; akaîá; kûara
vale - ybytygûaîa
valente - abaeté; kyre'ymbab/a; pyatã
valentia - pyatã (m)
vão (s.) - ybỹîa; pa'ũ
vapor - timbora
vara - ybyrá; ybyrá'ĩ; (de pescar): pinda'yba (m)
vários (as) - amõ
varrer - peir
vazar (intr.) - ẽ (ou en); nhe'ẽ
vasilha - (ep)uru (r, s); uru (r, s)
veado - sygûasu
veia - taîyka
velar - (intr.): ma'enan; kerarõ; (tr.): arõ (s)
velha - gûaîbĩ
velho - (adj.): pûer/a; umûan/a; (s.): tuîba'e
vencedor - moroîtykara [v. ityk / eîtyk(a) (t)]
vencer (tr.) - moaûîé; ityk / eîtyk(a) (t)
veneno - mba'etegûama; posangygûaba (m)
ventar - pytuur (xe), putuur (xe)
vento - ybytu
ventre - tygé
ver - epîak (s)
verão - kûarasy
verdade - mba'eeté; supindûara
verdadeiramente - eté (r, s); upindûara (r, s)
verdadeiro - eté (r, s)
verde - oby (r, s)
vergonha - tĩ
verme - (variedades): sebo'i; turuygûera; ura; ybyrapeasoka; ybyrasoka; tasoka; îaruma'i; taburaá, etc. 
vermelho - pyrang/a
verruga - kytã; kuruba
vesgo - (adj.): ró; esabang/a (r, s); (s.): tesabanga
vespa - kaba; (variedades): kabapuã; kabatĩ; kabesé; kabobaîuba; kasunununga, etc.
vestido (adj.) - aob
vestir - moaob; mondeb
vício - tekoaíba
vida - tekobé
vigiar - ma'enan
vinda - tura
vingar (tr.) - poepyk (o objeto é sempre uma pessoa: vingar alguém); epyk (s)
vir - îur / ur(a) (t, t) ● vir com; fazer vir consigo: erur
virar - (intr.): bak; nhemoîereb; (tr.): pobur; moîereb ● fazer virar consigo; virar com: erobak
virgem (adj.) - kûare'ym/a
virilha - takó
virtude - tekokatu
virtuoso - karaíb; ekokatu (r, s)
viscoso - pomong/a
visitar - sub (-îo-)
visível - îekuab/a
vistoso - matueté; aysó
viúvo (a) (adj.) - (m.): mene'õ; (h.) - emirekoe'õ (r, s)
viva! (= muito bem!) - aûîé!, aûîebé!, aûîebeté!, aûîé-katutenhẽ!, aûîé nipó!
viver - ikobé / ekobé (t); ikó / ekó (t) ● fazer viver: moingobé
vivo - ekobé (r, s)
vizinhança - amỹîoka; amundaba
vizinho (s.) - tambyagûá; amundaba; apyrixûara
voador - bebé
voar - bebé
volta - nhatimana; nhemoîereba
voltar - îebyr ● voltar com; fazer voltar consigo: eroîebyr
voltar-se - bak; erobak
vomitar - (tr.): moîebyr; (intr.): gûe'en
vômito - gûe'ena
vontade - temimotara
vos (pron. pess. obj.) - pe; opo- 
vós - peẽ; pe; peîepé ● a vós, para vós: peẽme; peẽmo
vosso (a, os, as) - pe
voz - nhe'enga

X
xingar - nhe'engybõ

Z

zangado - mari
zangar-se - nharõ; îeaseî
zombar - moîaru; memûã (xe); îaî (-îo-); nhemosaraî
zombaria - memûã
zombeteiro - memûã
zunido - sununga
zunir - sunung; nhe'eng
zurrar - nhe'eng

